NO ./assets/wall_4.xpm
SO ./assets/eagle.xpm
WE ./assets/wall_2.xpm
EA ./assets/wall_3.xpm
DR ./assets/door.xpm
DR ./assets/door.xpm

F 0,0,0
C 255,255,255

    11111111111111111111111111111111111111111111111111111111
    10000000000000000000000000000000000000000000000000000001
111110000000000000000000000000000000000000000000000000000001
10000000000000000000000111111111111111111111111111111111111111
100000111110000101010001
100000100010000000000001
100000100010000100010001
100000100010000000000001
100000112110000101010001
100000000000000000000001
100000001111100000000001
100000001   100000000001
100000001   100000000001
100000001   100000000001
100000001111100000000001
10W000000000000000000001
111111111000000000000001
110100001000000000000001
110000101000000000000001
110100001000000000000001
110111111000000000000001
110000002000000000000001
111111111000000000000001
111111111111111111111111