H1 ./assets/sonic1.xpm
H2 ./assets/sonic2.xpm
H3 ./assets/sonic3.xpm
NO ./assets/wall_4.xpm
SO ./assets/eagle.xpm
WE ./assets/wall_2.xpm
EA ./assets/wall_3.xpm
DR ./assets/door.xpm

F 102,102,51
C 153,102,153

    11111111111111111111111111111111111111111111111111111111
    10000000000000000000000000000000000000000000000000000001
111110000000000000000000000000000000000000000000000000000H01
100000000000000000000001111111111111111111111111111111111111
10H000111110000101010001
100000100010000000000001
10H000100010000100010001
10000010H010000000000001
10H000114110000101010001
100000000000000000000001
10H000001111100000000001
100000001   100000000001
10H000001   100000000001
100000001   100000000001
100000001111100000000001
10W000000000000000000001
111111111000000000000001
110100001000000000000001
110000101000000000000001
110100001000000000000001
110111111000000000000001
1100000H4000000000000001
111111111000000000000001
111111111111111111111111